{
  "maze": [
    ["#","#","#","#","#","#","#","#","#","#","#","#","#"],
    ["#","-","#","-","#","-","-","-","S","-","-","-","#"],
    ["#","-","#","-","#","#","#","G","#","-","#","#","#"],
    ["#","-","T","-","#","-","#","-","#","-","#","-","#"],
    ["#","B","#","E","#","-","#","T","#","-","#","-","#"],
    ["#","-","#","-","#","-","T","-","#","-","-","-","#"],
    ["#","T","#","#","#","#","#","L","#","#","#","#","#"],
    ["#","-","#","-","#","-","-","-","-","-","T","-","#"],
    ["#","-","#","-","#","G","#","#","#","#","#","#","#"],
    ["#","-","#","-","G","-","G","-","-","-","#","-","#"],
    ["#","-","#","-","#","#","#","-","#","#","#","-","#"],
    ["#","-","T","-","#","-","-","-","-","-","-","-","#"],
    ["#","#","#","#","#","#","#","#","#","#","#","#","#"]
  ]
}