{
  "maze": [
    ["#","#","#","#","#","#","#","#","#","#","#"],
    ["#","-","-","-","S","-","#","-","-","-","#"],
    ["#","-","#","-","#","-","#","G","#","-","#"],
    ["#","-","#","-","#","-","#","-","#","-","#"],
    ["#","#","#","T","#","#","#","-","#","-","#"],
    ["#","-","-","-","E","-","-","-","#","-","#"],
    ["#","#","#","#","#","L","#","-","#","#","#"],
    ["#","-","-","-","T","-","#","-","G","-","#"],
    ["#","#","#","#","#","T","#","G","#","#","#"],
    ["#","-","-","-","-","-","#","-","B","-","#"],
    ["#","#","#","#","#","#","#","#","#","#","#"]
  ]
}