{
  "maze": [
    ["#","#","#","#","#","#","#","#","#","#","#"],
    ["#","-","#","-","-","-","#","-","#","-","#"],
    ["#","-","#","L","#","#","#","-","#","-","#"],
    ["#","-","S","-","-","-","-","-","#","-","#"],
    ["#","-","#","#","#","#","#","G","#","T","#"],
    ["#","-","#","-","-","-","-","-","T","-","#"],
    ["#","-","#","#","#","B","#","#","#","#","#"],
    ["#","-","#","-","-","-","-","-","#","-","#"],
    ["#","-","#","G","#","#","#","#","#","G","#"],
    ["#","-","#","-","-","-","-","-","E","-","#"],
    ["#","#","#","#","#","#","#","#","#","#","#"]
  ]
}