{
  "maze": [
    ["#","#","#","#","#","#","#","#","#","#","#"],
    ["#","-","#","-","-","-","#","-","#","-","#"],
    ["#","B","#","T","#","#","#","-","#","-","#"],
    ["#","-","T","-","#","-","#","-","#","-","#"],
    ["#","-","#","S","#","-","#","G","#","L","#"],
    ["#","-","#","-","-","-","#","-","#","-","#"],
    ["#","-","#","-","#","#","#","-","#","-","#"],
    ["#","-","#","-","G","-","G","-","-","-","#"],
    ["#","-","#","#","#","#","#","#","#","#","#"],
    ["#","-","-","-","-","-","G","-","E","-","#"],
    ["#","#","#","#","#","#","#","#","#","#","#"]
  ]
}