{
  "maze": [
    ["#","#","#","#","#","#","#","#","#","#","#"],
    ["#","-","S","-","-","-","#","-","G","-","#"],
    ["#","#","#","#","#","-","#","#","#","-","#"],
    ["#","-","L","-","-","-","#","-","T","-","#"],
    ["#","B","#","#","#","#","#","-","#","#","#"],
    ["#","-","#","-","-","-","#","-","-","-","#"],
    ["#","-","#","-","#","#","#","E","#","#","#"],
    ["#","-","#","-","T","-","T","-","#","-","#"],
    ["#","-","#","-","#","#","#","-","#","-","#"],
    ["#","-","-","-","-","-","#","-","-","-","#"],
    ["#","#","#","#","#","#","#","#","#","#","#"]
  ]
}