{
  "maze": [
    ["#","#","#","#","#","#","#","#","#","#","#"],
    ["#","-","S","-","-","-","-","-","G","-","#"],
    ["#","-","#","#","#","#","#","#","#","T","#"],
    ["#","-","#","-","-","-","-","-","B","-","#"],
    ["#","-","#","-","#","#","#","#","#","-","#"],
    ["#","-","#","-","-","-","-","-","#","-","#"],
    ["#","L","#","E","#","#","#","#","#","#","#"],
    ["#","-","#","-","-","-","G","-","-","-","#"],
    ["#","-","#","#","#","#","#","-","#","#","#"],
    ["#","-","#","-","-","-","T","-","-","-","#"],
    ["#","#","#","#","#","#","#","#","#","#","#"]
  ]
}