{
  "maze": [
    ["#","#","#","#","#","#","#","#","#","#","#","#","#"],
    ["#","-","#","-","#","-","#","-","#","-","-","-","#"],
    ["#","-","#","-","#","-","#","-","#","-","#","-","#"],
    ["#","-","S","-","T","-","#","-","-","-","#","-","#"],
    ["#","-","#","T","#","#","#","#","#","T","#","-","#"],
    ["#","-","#","-","E","-","#","-","#","-","#","-","#"],
    ["#","-","#","-","#","-","#","-","#","-","#","-","#"],
    ["#","-","#","-","#","-","B","-","T","-","#","-","#"],
    ["#","#","#","#","#","G","#","#","#","#","#","T","#"],
    ["#","-","-","-","-","-","#","-","-","-","G","-","#"],
    ["#","#","#","#","#","#","#","#","#","L","#","#","#"],
    ["#","-","-","-","-","-","-","-","-","-","-","-","#"],
    ["#","#","#","#","#","#","#","#","#","#","#","#","#"]
  ]
}