{
  "maze": [
    ["#","#","#","#","#","#","#","#","#","#","#"],
    ["#","-","#","-","L","-","-","-","-","-","#"],
    ["#","-","#","-","#","#","#","#","#","#","#"],
    ["#","-","#","-","-","-","-","-","-","-","#"],
    ["#","E","#","#","#","#","#","S","#","#","#"],
    ["#","-","B","-","-","-","-","-","G","-","#"],
    ["#","-","#","T","#","#","#","#","#","-","#"],
    ["#","-","#","-","-","-","-","-","#","-","#"],
    ["#","-","#","#","#","T","#","#","#","-","#"],
    ["#","-","#","-","-","-","-","-","#","-","#"],
    ["#","#","#","#","#","#","#","#","#","#","#"]
  ]
}