{
  "maze": [
    ["#","#","#","#","#","#","#","#","#","#","#"],
    ["#","-","-","-","-","-","-","-","#","-","#"],
    ["#","#","#","#","#","-","#","#","#","-","#"],
    ["#","-","-","-","#","-","#","-","#","-","#"],
    ["#","T","#","#","#","-","#","E","#","-","#"],
    ["#","-","-","-","L","-","-","-","S","-","#"],
    ["#","#","#","#","#","#","#","#","#","-","#"],
    ["#","-","-","-","-","-","-","-","B","-","#"],
    ["#","#","#","#","#","-","#","#","#","-","#"],
    ["#","-","T","-","-","-","-","-","#","-","#"],
    ["#","#","#","#","#","#","#","#","#","#","#"]
  ]
}