{
  "maze": [
    ["#","#","#","#","#","#","#","#","#","#","#","#","#","#","#","#","#","#","#","#","#","#","#","#","#"],
    ["#","-","#","-","-","-","#","-","L","-","-","-","-","-","G","-","-","-","-","-","#","-","#","-","#"],
    ["#","G","#","E","#","#","#","-","#","#","#","#","#","-","#","#","#","G","#","G","#","-","#","-","#"],
    ["#","-","#","-","#","-","#","-","#","-","-","-","G","-","#","-","-","-","#","-","#","-","G","-","#"],
    ["#","-","#","-","#","-","#","-","#","#","#","#","#","#","#","G","#","#","#","#","#","-","#","-","#"],
    ["#","-","G","-","#","-","#","-","#","-","-","-","-","-","G","-","-","-","-","-","#","-","#","-","#"],
    ["#","-","#","-","#","S","#","-","#","T","#","#","#","#","#","#","#","#","#","#","#","#","#","-","#"],
    ["#","-","#","-","-","-","#","-","#","-","T","-","-","-","#","-","-","-","-","-","-","-","T","-","#"],
    ["#","G","#","#","#","#","#","-","#","T","#","#","#","-","#","-","#","#","#","#","#","-","#","-","#"],
    ["#","-","#","-","-","-","#","-","#","-","#","-","-","-","G","-","-","-","G","-","#","-","#","-","#"],
    ["#","-","#","T","#","-","#","-","#","#","#","#","#","G","#","#","#","#","#","#","#","-","#","-","#"],
    ["#","-","T","-","#","-","#","-","#","-","G","-","-","-","-","-","-","-","T","-","#","-","#","-","#"],
    ["#","G","#","#","#","#","#","-","#","T","#","#","#","#","#","T","#","#","#","#","#","G","#","T","#"],
    ["#","-","-","-","-","-","T","-","#","-","T","-","-","-","#","-","-","-","T","-","#","-","#","-","#"],
    ["#","#","#","#","#","#","#","#","#","#","#","B","#","#","#","#","#","#","#","#","#","#","#","#","#"],
    ["#","-","G","-","G","-","T","-","#","-","#","-","-","-","#","-","-","-","#","-","-","-","G","-","#"],
    ["#","#","#","T","#","T","#","T","#","-","#","-","#","-","#","T","#","#","#","-","#","#","#","-","#"],
    ["#","-","G","-","#","-","#","-","#","-","#","-","#","-","#","-","-","-","G","-","-","-","#","-","#"],
    ["#","-","#","#","#","#","#","#","#","-","#","T","#","#","#","#","#","#","#","#","#","G","#","#","#"],
    ["#","-","T","-","#","-","T","-","#","-","#","-","G","-","#","-","-","-","-","-","-","-","T","-","#"],
    ["#","-","#","-","#","T","#","#","#","G","#","#","#","G","#","-","#","#","#","T","#","#","#","-","#"],
    ["#","-","#","-","#","-","T","-","#","-","G","-","-","-","G","-","#","-","-","-","-","-","#","-","#"],
    ["#","T","#","#","#","-","#","-","#","#","#","#","#","G","#","-","#","#","#","#","#","#","#","#","#"],
    ["#","-","-","-","T","-","#","-","$","-","-","-","-","-","#","-","-","-","-","-","-","-","-","-","#"],
    ["#","#","#","#","#","#","#","#","#","#","#","#","#","#","#","#","#","#","#","#","#","#","#","#","#"]
  ]
}