{
  "maze": [
    ["#","#","#","#","#","#","#","#","#","#","#","#","#"],
    ["#","-","-","-","-","-","-","-","-","-","G","-","#"],
    ["#","#","#","#","#","#","#","#","#","#","#","-","#"],
    ["#","-","-","-","-","-","T","-","-","-","E","-","#"],
    ["#","#","#","#","#","#","#","#","#","B","#","-","#"],
    ["#","-","L","-","#","-","#","-","#","-","#","-","#"],
    ["#","-","#","-","#","-","#","-","#","-","#","-","#"],
    ["#","-","#","-","#","-","#","-","#","-","#","-","#"],
    ["#","-","#","S","#","-","#","-","#","-","#","-","#"],
    ["#","-","#","-","-","-","T","-","-","-","#","-","#"],
    ["#","#","#","#","#","G","#","T","#","T","#","-","#"],
    ["#","-","-","-","$","-","#","-","#","-","#","-","#"],
    ["#","#","#","#","#","#","#","#","#","#","#","#","#"]
  ]
}