{
  "maze": [
    ["#","#","#","#","#","#","#","#","#","#","#"],
    ["#","-","T","-","-","-","#","-","E","-","#"],
    ["#","#","#","G","#","#","#","G","#","#","#"],
    ["#","-","-","-","L","-","#","-","G","-","#"],
    ["#","-","#","#","#","G","#","-","#","-","#"],
    ["#","-","#","-","-","-","-","-","#","-","#"],
    ["#","-","#","-","#","-","#","-","#","-","#"],
    ["#","-","#","-","#","-","#","-","#","-","#"],
    ["#","#","#","#","#","#","#","S","#","#","#"],
    ["#","-","-","-","-","-","B","-","-","-","#"],
    ["#","#","#","#","#","#","#","#","#","#","#"]
  ]
}